1111111111111111111111111111111111
1000000000000000000000000000000001
1000000000000000000000000001111111
100000000000000000000000000011111
1000000000000000000000000000000001
100000000000000000000000000000001
1000000000001010000000000000000001
1000000000001P1000000000000000001
1000000000000100000000000000000001
1000000000000000000000000000000001
1000000000000000000000000000000001
1000000000000000000000000000000001
1000000000000000000000101000000001
100000000000000000000011100000001
1111111111111111111111111111111111