1111111111111
000000000000000
1111111111111111111