11111111111111111
10000000000000001
100000000000P0001
1111111111111111111
