NO ./texture/holey-cheese-256x256.xpm
SO ./texture/holey-cheese-256x256.xpm
WE ./texture/holey-cheese-256x256.xpm
EA ./texture/holey-cheese-256x256.xpm

F 220,100,0
C 225,25,0

1111111111111111111111111111111111111111
1N00000000110000000001100000000110000001
1011011111101101110101101110110110111101
1010000000001001000100100010010010000001
1011111011011101110111101110111011111101
1000001010000000000100000000010000001001
1111011111110111110111110111110111101101
1000000000010000010100000100010000100001
1011111111011111010101111101110110111111
1010000001010001010100100001010010000001
1010111011010101010110110111011011011101
1010100000000101010100100000000010010001
1010101111111101010101101111111110110101
1010101000000001010101001000000010100101
1010101011111111010101111011111010101101
1010101010000000010100000010000010100001
1010101010111111010111111110111110111101
1010000010000001000100000000100000000101
1011111011111111110101111111101111110101
1000001000000000000101000000001000010101
1011101111111011111101011111111011010101
1010001000001010000001010000100010010101
1010111011101010111111010110101110110101
1010100010101000100000010100101000100101
1010101110101111101111110101101011101101
1010100000100000001000000101001000001001
1010111111111111111011111101111111111001
1010000000000000100010000100000000001001
1011111111111110101110110111111111101101
1000000010000010101000100100000000100001
1011111010111010101011101101111110111111
1010000010100010101010001000000010000001
1010111110101110101011111011111011111101
1010100000001000101000000010001000000101
1010101111111011101111111110101111110101
1010101000000010001000000000100000010101
1010101011111111111011111111111011010101
1010000010000000000010000000000010010001
1011111111111111111111111111111111111101
1111111111111111111111111111111111111111