NO ./texture/holey-cheese-256x256.xpm
SO ./texture/holey-cheese-256x256.xpm
WE ./texture/holey-cheese-256x256.xpm
EA ./texture/holey-cheese-256x256.xpm

F 220,100,0
C 225,25,0

 111111111111111111
10000000000000000001
10000000000000000001
10000000000000000001
10000000000000000001
10000000000000000001
10000000000000000001
10000000000000000001
10000000000000000001
10000000000000000001
10000000000000000001
10000000000000000001
 111111111111111111