NO ./texture/brickwall1_64.xpm
SO ./texture/floortiles.xpm
WE ./texture/templewall01.xpm
EA ./texture/stonewall1_64_1_.xpm

C 225,25,0
F 220,100,0

11111111111111111111111111111111
10000000000000000000000000000001
10000000000000000000000000000001
10000000000000000000000000000001
10000000000000000000000000000001
10000000000000000000000000000001
10000000000000000000000000000001
10000000000000000000000000000001
1N000000000000000000000000000001
11111111111111111111111111111111