NO ./texture/brickwall1_64.xpm
SO ./texture/floortiless.xpm
WE ./texture/templewall01.xpm
EA ./texture/stonewall1_64_1_.xpm

F 0,0,0
C 0,0,0

11111111111111111111111111111111
10000000000000000000000000000001
10000000000000000000000000000001
10000111111111000011111111100001
10000100000001000010000000100001
10000100000001000010000000100001
10000111001111000011100111100001
10000001000100000000100010000001
10000001000100000000100010000001
10000001000111111111100010000001
10000001000000010000000010000001
10000001000000010000000010000001
10000001111111110000111110000001
10000000000000000000000000000001
10000000000000N00000000000000001
10000000000000000000000000000001
10000001111111110001111110000001
10000001000000010001000010000001
10000001000000010001000010000001
10000001000111110001000010000001
10000001000100000001000010000001
10000001000100000001000010000001
10000111111100000001111110000001
10000000000000000000000000000001
10000000000000000000000000000001
10000111111111111111111110000001
10000100000000000000000010000001
10000100000000000000000010000001
10000111111111111111111110000001
10000000000000000000000000000001
10000000000000000000000000000001
100000001000000000000000100000001
10000000000000000000000000000001
10000000000000000000000000000001
10000111111111000011111111100001
10000100000001000010000000100001
10000100000001000010000000100001
10000111001111000011100111100001
10000001000100000000100010000001
10000001000100000000100010000001
10000001000111111111100010000001
10000001000000010000000010000001
10000001000000010000000010000001
10000001111111110000111110000001
10000000000000000000000000000001
10000000000000000000000000000001
10000000000000000000000000000001
10000001111111110001111110000001
10000001000000010001000010000001
10000001000000010001000010000001
10000001000111110001000010000001
10000001000100000001000010000001
10000001000100000001000010000001
10000111111100000001111110000001
10000000000000000000000000000001
10000000000000000000000000000001
10000111111111111111111110000001
10000100000000000000000010000001
10000100000000000000000010000001
10000111111111111111111110000001
10000000000000000000000000000001
11111111111111111111111111111111