NO ./texture/brickwall1_64.xpm
SO ./texture/floortiless.xpm
WE ./texture/templewall01.xpm
EA ./texture/stonewall1_64_1_.xpm

F 0,0,0
C 0,0,0

11111111111111111111111111111111
10000000000000000000000000000001
10000000000000000000000000000001
10000000000000000000000000000001
10000000000000000000000000000001
10000000000000000000000000000001
10000000000000000000000000000001
10000000000000000000000000000001
1N000000000000000000000000000001
11111111111111111111111111111111